aa	個, 各位
ac	apg, 跟, 一些
activity	
advisor	
ae	aum
afec	asset
aisamoney	非常歡迎
always	al大概
amu	aum, aum
announce	
another	拉得
asiamoney	最小
asian	center
balance	
ban	
bankging	consumerbanking
banks	
best	
bi	vis
boa	bo本
bonus	齁, 是
brake	呆帳
brokerage	mortgage
busu	利潤
buy	ir, 可以
by	
cape	方面
cardhol	的
cardhold	的
cardlink	
cards	cost
carrefour	pay國, 開戶
cet	tier, q, gdp
chain	
co	cost
color	
consultant	
coveragage	也
covi	單一
covid	一, 後面那
cpi	一到, eps, 十七年, eps
cs	bis
currency	
current	ratio
day	
dci	必須要, 個第一
delivetive	
delta	卡
depends	
der	
digit	
division	
dninteen	的
driven	
dywa	包括
epn	
eps	次, 以及, dps
es	
esc	
esg	就, 業界, 第二, 就, 業界, 因, 因為, 也提, 裡面, 業s, 營業, 醫, ncd, 營業, 月相關, 跟, 應該, 業界, 業界, 業界, 業區, 企業, 也, 一十一, 因, 業界, 也取得
etf	
face	fixed
fail	tmu, fair, ir
fat	
feel	是
fees	fixed, fixed, 銀行
fi	free
financial	
fingo	或
fit	
for	corporate
forbes	bank, 大
formosa	很多, 發放
frtb	會發七億
fvpl	equity, 欸, apg
giv	呃c
global	呃, 過
governance	大陸
gp	決定
gps	eps
grade	那
gri	i
grm	q人
holding	
home	
hrr	是
ht	
hte	
htt	當然
ibc	機構
icu	
idc	it
if	
ihf	
ihs	
im	
impact	銀行
inaf	但這個
incomeand	income很
inf	imf
inflation	上面, 開類也, 覺得
installment	
internal	
ipo	io
ir	還要, 呃還要, 的, 那
ird	idrp, 壓力, 阿法
irs	rm
issue	因素, 因素
ite	
ixml	開發每
jasons	監會
kpi	推
kyc	邁新
later	
limited	認者
loan	業界
lock	
lockdown	
logo	
ltb	
ltv	roe, 個vp, ldr
managed	
mark	延動, market, dividend
marking	
max	在
maybe	每
mgm	
mission	目前
mma	一
momo	
msci	資料
negative	那個
ni	一
nim	利差, 面下降, 面會, 日i, 因為, 呃nim, 那, 是, 你, 費, 明年
nineteen	一次
ninteen	季
not	會
now	
npl	在, 第二季, 的npl, 當然, 月, 而, 只有, 嗯f
nri	nii, 大家
oc	
oci	都, 歐, weal, oi, obu, 放, 公司i, 幾乎, 個某, 歐i, 都
ok	可以, 可以
online	房貸
only	呃
onlycard	一些
opec	歐的
operating	expands
oriented	
overlord	npl, bisratio
pb	區地, 企金
pbu	區域
pc	彼此
pchome	income, ecb
pecent	percent
percemt	個percent
percentc	percent
performers	
persona	
pertcent	個percent
pi	開, 安全, 派股, 前, 簡報, 開, 它, 台, 開發, 台北
picture	提存
pl	npl, pm這
position	
power	
powerpoint	
pread	spread
prime	
principle	
priv	台ing
program	
project	嗎
pv	p, 滿到
pvc	cev
qa	去, 機會
rank	在整個, 可能會
ranting	arating
rates	
ratings	請
re	our, 阿
reopen	有可能, 流程
revenue	
roe	銀行roe, 的roe, 一個
run	讓
sales	自由分配
sanction	
sasb	
sb	c
sbt	的
scoci	ipi
sdt	
service	
servtive	的
single	
six	活
slightly	
sme	跟, 利放, 二sme, 整體, 的sme, 一, a
smp	獲, sme
sop	
spead	spread
spread	spray, 部位, 對, 不會, 各位, 對, 對, 缺法那對, 會, 方面, expands, 各, 在, fed, spread呃, 的, 不會, 各位, 的
ss	fs
straight	
supply	掃
supposely	
sustainalytics	的
svpi	
swot	
syngo	
tcfd	一, 第一到, 幾c
team	淨在
teamwork	聽客
test	
tmfd	經營
tnu	tmu
topec	都在
travel	的
tw	一
twenty	連
ubear	因為, 啊
ubs	發行, 日f
um	呃
unlikely	minus
upc	ucb
very	呃
view	吼
voa	maybe
voci	boci
volatility	策略
vp	預計, bp, bp, bp, bp
vpl	att喔
workbase	
yo	yoy
you	obu
ytm	
一七	佔
一下來	以下
一九一八一七	一九年
一九九二年	一九年, 一九點, 九月
一九九四年	四年
一五	二零一八
一兆五	一兆我們
一兩點	兩點
一八年	一百一十七
一千三百三十五	三百三十五
一千六百億	對一千六百億
一千四	一千嘛
一千萬兩千萬	兩千萬一千萬
一千零八十四億	一三零八十元
一同	一頭
一年期	一年
一慣	一貫
一成	預測
一時	
一本初衷	出
一模一樣	
一百一十	一百一四
一百一十一點八億	十一百一十一點八億
一百一十九	一百一十九點左右
一百一十六點零五	一百一十六點五
一百三十七億	一百七億
一百三十九點七億	三十九點七億
一百三十五點五億	一百三十五點五一, 一百三十五點五元
一百三十六九	一百三十二點六九
一百三十六點二零	一百三十六點二
一百三十六點五四	個一百三十六點五
一百三十四點二九	一百四點二九
一百三十四點八億	百分之一百三十四點八億
一百九十八點三億	一百九十八點的, 一百九十八單月
一百二十二點七	二十二點七
一百二十六點十	一百二十六點七
一百五	一百
一百五十九點零五億	一百五十九點五億
一百五十八	一百玉山
一百五點二	一百五十點
一百八十	把
一百八十點二億	一百八十八億
一百六十八	把一百六十八
一百四十六點四億	一百四十六點七億
一百四十多萬	百分之多萬
一百零三點一三	一百零三點
一百零三點八	百分之一百零三點八
一百零三點四零	一百零三點四
一百零二年	一百零二
一致性	次性
一路	的
一點七五兆	一點七五
一點七幾	一點七四
一點三三	一點二零零四一點三三
一點三五兆	一點三兆
一點三八兆	一點三兆
一點三四	一點四
一點二零	一點二個, 一點二零零四一點三三, 一點二一, 一點所以
一點五九兆	一點無大
一點五五兆	一點五兆
一點五八八	一點五八元
一點五六	一點五個
一點八五兆	一點八兆
一點八兆	一點八的
一點八萬	一點七萬
一點六兆	一點六到
一點六兆多	一點六兆
一點四一點五	一點四點五
一點四二一	一點二一億
一點四二年	一點四二的
一點四四	一點四一, 的四十
七八八九月	七八九月
七十來億	七十八億, 七十億
七十四點七	了七十四點七
七十點九億	七十點九一
七千億	七千
七百四十三點八	七百四三點八
七百多萬	七百萬
七點九六	十七點九六, 今年九月
七點五二	七點五
七點八億	七點八, 七點七八億
三一零	三一, 三一年
三三	
三兆	三, 三到, 按照
三八	上八
三十七八	其他
三十七點九	九個
三十三點零	三十三點一
三十二十點五	三十二點五
三十億二十	三十一二十
三十八點五	三點
三十六點四二億	三十六點這
三十六點零	三十六點一
三十四點四	那四點四
三千三百六十六	三千三百六六億
三千億十	三千十
三千兩百六十二億	三千兩百六十億
三千兩百零四億	兩百零四億當初
三千六百多億	三千六百多出來
三四五	單五
三四十	三
三四月	三次
三四月份	三十四月份
三百三十億	三百三十一, 三百三十一
三百五十萬	三百一十萬
三點一	三點一七, 給一
三點三億	三點三而
三點三兆	
三點二五億	三點二一
三點二六兆	三點二六
三點四四	三點四
三點零二兆	三點六
三點零五兆	三點零兆
上上	上
上上下下	
上到	到
上架	些人
上班	放, 上
上綱	上班
上繳	上漲, 上漲
上臺	
上調	
上路	今年
下下	向, 下降
下下滑	一下下滑
下下降	向
下方	上
下載	下
不一	不
不不僅	不僅
不不只	那
不住	不錯
不便	
不如	不
不明	這
不滿	不能
不良	未來
不諱言	不免, 不元
並進	季第一
中授	中壽
中斷	東館
中端	中央
中階	中間, 中間
主地	董事上說
主流	主要, 主軸, 主軸
之上	
之於	
九九年	第九年
九六	十點九二
九十一	
九十一八	九十八
九十一點八	六十一點八
九十二點二億	九十二點, 九十二點元
九十八	只是
九十八點七億	九年七億
九十八點三億	只八點三億
九十八點五一	九十八點五
九十八點五億	八點五億
九十六點八億	九點八億
九千	首的
九千三百九十二	九千三百九億
九千多	十九千都
九州	九的
九成多	承做
九時	九十九點一
九百	五百
九百一十二億	一十二億
九百三十三億	三十三億
九百六十七億	provision
九點一九	九十九點一個
九點三萬	
也就是是	也覺得
事事	
二一	唯一
二一年	規模, 了今年, 二零一年
二七	零點二五
二三月份	三月份
二二	一點二二, 一點二二
二二年	二零一二年
二五	在, 九億第四五
二八	十一點八
二八九點四億	二八九點七億, 到八九點四億
二六	零點二五
二十一點二	二一點二, 二十一點二三
二十一點四	二十一點一
二十九點二	八十九點二
二十九點四	三十九點四
二十二十幾	二十幾
二十二點六	三十六點六
二十二點四億	二十二點元
二十五點一	一二十五點
二十五點三	二十五點
二十五點零億	二十五點
二十八點六	百分之八點六
二十八點六七億	二十八點六七
二十六點八	
二十四點四	在
二十多億	小調都
二十齁	關係齁
二零一二	二零零六
二零三二年	二零零三年
二零三五	
二零三五年	二零一三年, 二零一三五
二零三零	二零零三年, 二零一三年
二零三零年	二零一三年
二零二	二零一二年
二零二一	二零一零二啦, 二零一五一, 而會, 二零二一下, 二零一年, 對於二零一
二零二一二二年	二零一二年
二零二三年	二零零二成, 二零三年, 二零三年, 二零一二年, 二零零二年
二零二二	二零零二件, 二零一二年, 二零一二, 二零一六年, 零二
二零二五年	二零
二零二呃	呃
二零二四年	二零零二四年
二零二零	二零一五一, 二零一呃, 二零零, 二零一二年, 二零零的, 二零一二年, 二零零
二零二零一六一七	二零一二年
二零二零二二年	二零一二年
二零二零財	是二零
二零五零	二零零, 經營
二零五零年	二零一五年, 二零一五年, 二零一五年
二零四零年	二零一四年, 二零一四零年
二零年	幾年
二零零二年	二零一零年
二點三七兆	二點三一兆
二點九七兆	二點九人
二點九五兆	二點九兆
二點九兆	二點九, 第二點九兆
二點二五兆	二點二兆
二點二兆	二點
二點二零	二點會, 二零零, 二點二五
二點五八兆	二點五兆
二點六五兆	二點六兆
二點四兆	二點四
互利	獲利
互聯網	一, 固華
五五六百億	五六百億
五倍	五
五倍券	五倍
五六十	六十八
五六月	五六億, 五六, 五月
五十一點七	五十一點七月份
五十一點七億	五十一點七, 五十一點七跟
五十七億	多五十七
五十二五十三五十	不是單子五十二
五十二點七億	五十二點七, 五十二點七
五十五十一半	五十一
五十八點一	五十八點一四
五千億	五千多到
五時二	五十二
五百六十二	五百十二
五百六十二點五億	五百六十二, 快六十二點五
五萬	五萬呃
五趴	四點五趴
五點	五點五, 五點八, minus
五點九億	五點九一, 五點九年
五點八八	五點八
五點四六	五點四個, 五點到
五點零	五點
亞太區	開區家
交接	交易
交易型	非的
交通	交公
人們	人員, 剛剛, 當然
人材	
人民	人行, 我們, 你們
人資	是
介入	業務
以以	就
以内	
以為	來
以爲	以為
以至於	以, 以, 一, 以, 你自己, 一次
份額	
企業主	企業處, 企業組
企消金	企金, 金消, 製銷
企金法	是非常
估價	國家
估算	部分
伴隨	辦成
佈署	
低到	到
低吼	第一齁
低率	利率
低用電戶	利用
住宿	就數
佔比士	占比是
佔起來	放款
何時	的是
作帳	
來成	來
來至於	
供應	公益, 方面
供應鏈	公率
供電	公店, 禮拜或是
依樣	一樣
依然	個一, 原來
侷限	現在
便利性	便利
便宜	全年
便捷	遠, 變
便是	是, 是
促進	報告
俄國	額國
保全	保權, 之後, 保險
保持成	保持很
保款	我們
保証	保費
保障型	大型, 保險性, 當然
保障險	保型
保險金	一些
保額	
信保人	現法
修改	修齁
個位數	各位
個資類	固類
個項	各項
借借給	借
借息	資常, 具戲
倡議	舉對
偏期	長期
偏鄉	簽商, 天商, 像
做出	做上
做對	做
做為	做
停售	提後
停放	的
停止	指到, 儲值, 卡
健保費	建, 監費
健全	建確
偵測	分布, mo色
偽冒	為
傑出	出也
備用	費用
催款	他把, 支付寶
傲人	抱人
債債	在於
債元	債券
債券型	前, 債券, 代行
債券票	債票
債呃	在呃
債市	代事
債息	花
債票	大家
債票券	在跨界
傾向於	像於, 氣象
價期	降息
價碼	
儘快	這
儘管	主管, 以外
償券	產確
償還	
償金	長期
優化	遊化, 把
優秀	
優良	優
儲放	存放
允當	整
充沛	大
先前	先
克服	扣
免疫力	每一
入境圖	固出
入帳	
內包	賣, 辦法
內用	
全家	前加
全心全意	次決議
全盈	全
全盈加	加可以
全網銀	同仁
兩千四	零點四
兩千四百億	兩千四億
兩千零五十四億	兩千零十四億, 兩千零四億
兩年期	兩年
兩百兩百五十	個都是一
兩百八十	兩岸
兩百零五點七億	兩百五點七億
兩眼	
兩萬	兩位
兩萬兩千	兩岸兩千零
八八成	八
八十八點七	八八點七
八千七百一十八	八千七百一十八億
八千多	八千多到, 八千多點
八百三十二億	八百三一
公債值	房貸
公克	公
公園	透過
公家	東佳
六一	九億第四五
六七十	七十六七十
六之四	
六九	零點六九
六五	六兆, 六五點二十
六十一十四二十三	六十一只二十三
六十五點五	六十五
六十點一	
六百一十二點五	一十二點五
六百一十五點五	六百一十五點五percent, 六百一十五點五percent
六百五十六點三	六百五十六點三四
六百四十九點四	六百四九點四
六百多	六百多人
六點七億	十六點七億
六點多	六點
六點零	六點一
共同體	密體, 工具
共存	動能
共襄盛舉	申請
其餘	絕到, 七億, 許
典範	兩大
兼任	偏
内容	
再一次	但是
再生	在, 的, 身, 代升, 人員
再過來	包括, 後來
冒用	報用
净值	淨值, 淨值
净利	淨利, 證券, 淨利
净利收	說今天, q, 呃淨收益, 淨利息, 淨利收
净增量	認為, 到, 競爭量
净成長	淨成長
净手	所, 手净
净手收	淨手收, 進手
净提	淨提存
净提存	淨提存
净額	會進合
凱基	
凱西	證券
出國	出口, 處, 清楚, 出
出手	出售
出遊	也
分出來	更出來, 分
分別台	分點台
分向	分項
分子	分行, 子行
分子行	
分擔	
分期	申請
分歧	
分水嶺	分損率, 分利, 分水, 分名, 分利, 分損率
分片	方面
分留	分別
分紅	分口, 分恐
分過來	再來
分配款	分配, 分配
分開	
分開成	分開兩
分面	方面
分頁	後面
分類點	美元
切出去	儲蓄會
列作	要列做
列居	
列席	列期
列管	
初估	初步, 這
初衷	副動
初頭	出頭
判定價	看併
利呃	比呃
利基	利率
利得	
利話	利率
到來	倒來
到到	到, 到
制定	有
刷卡量	發卡量, 發卡量, 發卡量
剔除掉	提掉
剛剛好	剛好
剛性	當初, 當性
副四點八	四點八
副經	付
副行長	副行債
創新獎	創新
劃劃	
功夫	公布
功效	東效
加劇	加去
加加緊	叫家庭
加大	拉到
加强	加上
加重	加動
加量	分量
動工	動作
動性	流動性
動蕩	重大
勝任	深任
勞工	到風
北富銀	推出
匯入	匯率, 匯率
匯回	會回, 匯為
匯率息	淨利息
區返	七百
十一趴	其他
十一點七十	十一點七四
十一點四四	十點四四
十七點三	五十七點三
十三點九	四十三點九
十三點六	降三點六, 是三點六
十三點零	單點
十九點	十九點一
十九點三六	九點三六
十五十六	十六
十五點七	九點七
十五點五	十二點五
十五點六四	五點六十
十五點零	十五點八
十八點一	第十八點一
十八點七	八點七
十八點二五億	四十八點二億
十八點五	八點五
十八點六	十八點九
十分	是, 十三
十十十一億	十一億
十四十五	十五
十四樓	第四
十四點	十四點一
十四點一七	一七
十四點一三	四點一三
十四點一九	四點一九
十四點七七	四點七四
十四點九	十四點九元
十四點二	四點二
十四點五	四點五
十四點八	四點八
十四點八九	十四點八
十四點八五	四點八個
十四點六二	四點六二
十四點六四	四點六四
十四點四四	自然
十四點零	十四點三
十四點零七	是四點零七
十成	
十點九	是跟九
十點九六	
升到	升
升溫	例溫, 相關, 狀況
協會	結果
協調	一些
南韓	拿
占到	到, 漲到
占比表	占比是
厚望	自己
原定	的一
原幣	回
原有	有
原油	六過
原生	延伸
去去	去積極
去掉	掉
參閲	開業, 開業, 單月
及時	即使, 其實, 其實, 其實
反之	敢
反彈	的三, 反, 反倒
反復	緩步
反映出	反
反映出來	反映啦
反覆	管戶
反轉	完走, 優異
受制於	受於
受控	股建後
受理	送, 受益會
句點	據點
只不過	
叫起來	起來
召開	他, 到, 預估
可取	可喜
可否	說明, 能夠, 可以, 歐問
可喜	開始, 可
可惜	可地, 可以
可望	很, 成長率, 機會, 可能, 要比
可期	科技, 科技, 客群, 可, 呃科技, 客群
可見	跟
台中	開中, 臺中
台呃	呃
台大	了, 大
台管	台灣
台美	每一
台股	開戶, 吼
史密斯	是
右上角	又上漲
右下角	也
右右手	用
吃緊	
各自	科技
合宜	回覆
合計	合具, 投資
合資	投資
名列	每月
名列前茅	零點
含幣險	地準
吳洪真	宏跟
吼吼	齁
吼量	齁量
呃占率	呃飯率
呃卡	呃好
呃呃	呃
呃存	呃
呃客	呃
呃客群	噢客群
呃平	呃
呃成	呃
呃法	呃
呃玉民	呃
呃額	呃
周到	周導
周嚴	多元
周年慶	東南, 公年
周邊	大邊
呼吸	補線
呼吸器	付
呼應	歐
命運	密體, 民營
咱們	才, 增加, 加人
哎呀	欸
哲學	的折呃
商務客	商然後
問答欄	問題
問道	問到
啟動	提動, 舉
善用	概括用, 帶用
善盡	在
喜悅	十月, 十月
單日	日點
單行	大概
單點	日點
嚇一跳	下降
嚇到	達
嚴嚴	累積
嚴控	延後
四三	一千一點四三
四五六三	四十六
四五月	四月, 四月, 四月
四十七點五億	是七點五億
四十三點三億	四十三點元
四十四四十五	
四十四點三	是四十點三
四十點九二億	四十四點九億
四千七百二十七億	四千二十七億
四四	一點四四, 一點四四
四小	
四百七十二億	了四百七十二億
四百三十六萬	四百六萬
四百五十三點三萬	卡到五十三點八萬
四百四十	四百四
四百四十八萬	四百萬
四百零二萬	四百零萬
四萬五千多	五千多
四萬多	四萬
四點一二	十四點一二
四點一五	四點五
四點四二	四點二年, 四點二
回售	回收
回彈	回來
回復到	五成
回復性	回復是
回歸	微薄
回衝	類, 會從
回過	會不會
回頭	回到
回顧	回覆, 元
固資	補來
國人	不管, 國外, 國內, 國內
國内外	國內
國吼	當然
國境	國際
國發會	國會
圖書館	儲聯, 主計
圖資	投資
在下	上在
在來	第一, 在, 再來
在地	在
在檔數	
地域	第一
地步	一步
地球	
地緣	遞人, 認
地雷	地位
均勻	不經營
坊間	
坪數	評數
執行力	執率
執行期	這邊, 年輕
培訓	年可以
基層	整, 基礎, 經營
基建	機艦
基本盤	資本
基母	其實
基準	清楚
基礎值	基礎
基金會	經會, 基金
報告書	報告說, 報告
報酬率	報利
塞車	三成
墊高	變高
增加額	增加
增增	分量
增審	徵審, 升, 都, 增成
增幅	這樣, 政府, 增, 整足, 跟
增強	增長, 分享
增數	分數, 政策
增速	跟
增長率	成長率, 成長率
增長額	增長的
增高	升高
壓縮到	加
壞帳率	率
壯大	到
外交	
外債	海外
外包	啦
外匯款	外匯
外幣票	外幣, 外幣
外訪	外匯
外賣	的
多一點點	多一點
多出來	多百
多於	多, 對於
大事	大是
大個	放之下, 上
大半	慢慢
大同	大通
大名	大
大大	
大大小小	大
大戶	大步, 大部分
大腦	大
大規模	的包括
太陽能	他原來
央債	量
央票	兩條
失業	csr
奧運	高興
好友	靠
如期	期
妥適	股色
委員會	也會
委會	
子利率	利率
存入	程度
存戶	
存控比	存放比
存有	淨提存有
存款戶	存款或者
存續	十間, 七
存量	個, 成量
季結	
孩童	
學人	
學童	學齁
學院	月
守護	手, 同
安心	系一點
安排	方
安養性	還有
完善	往上
官司	關係
官網	觀察
定下	最大
定位成	定位
定案	購案
定率	利率
定量	並
客戶群	客戶權
宣告	現在
宣導	把先
宣布	個全度
宣示	每, 是
宣誓	深色
家人	的
家園	加員, 有
寄以	我們
寄望	盡量, 計one
寄過來	過來
富庶	復甦, 復甦, 復甦
富比世	或許
富比士	不比, 這
富管	財富
實品	持平
實收	子收, 吸收, 個實收
實習	呃實體
實行	是
實踐	時間
寧願	明年
審查	
寬限期	觀高, 關鍵
封控	
將要	
專注	
尊敬	經營, 建進
對標	
對比	對
對準	對整
對話	背話, 對, 對, 的話
導正	房貸
小於	以, 以, 比
小時	市場
少於	少, 上
居多	floating
居家	基金, 一家
展延	感覺
展望期	展望
展期	期的
展開	掌開
層數	卡數
履歷	這樣子
峰會	次, 分會
峰款	的
巨擘獎	去
差異化	綜合
市佔	製造
市價	家四
市占	
市政府	政府
布里斯	布里斯本
帳款	放款, 放款
帳號	
帳面	上面
帶大	帶來
帶領	
常態	談場, 轉換
常見	強勁
常規	
干擾	呆帳, 擔保品, 擔保
平價	存照
平坦	平臺
平安	天南
平息	情形
平損	提存, 那
平盤	平台
平等	
年增	連
年增為	為, 原為
年齡	年底
幸好	
幸運	現金, 確定, 心意, 盡力
幹事	玉山
幾加	幾家
幾千	外匯
幾率	gdp
底定	低定, 低, 低的
底部	第步, 併多, 到底
店面	一點點
度過	住購
康復	
廣受	受
延攬	聯案
延期	元期
延續到	有提到
延長	銀行
建案	啦
建造	變到
引擎	以前
引用	都
引發	匯發
引道	
張數	當初
張智星	當性
強健	強勁
强健	
强烈	強烈
彈升	單身
彌補	鼓
彙整	知道
形態	情況
形成	年度
影想	影響
影響面	影響
影響項	是影響
彷彿	大幅
往來數	往來, 往來
往後	往
往返	廣房貸
後年	
得以	
得意	
復刻	顧客
復工	
復發	地方
循環面	時方面
微笑	像
徹施	每客
快要	要
急凍	結構
急用	只用
急遽	繼續
恆大	大很, 很大
恐怕	統套
患者	飯則
想問	問
愛護	
感到	等到
應對	定備
應變	力, 意見
成交	成交的話
成分	可能
成就	很
成成爲	成長
成長力	成長率
成長展	成長
成長所	成長手續費
成長期	成長
成長為	成長了
或者是	是存款或者
截止	
戰勝	戰升
戰爭	
房市產	房地產
手下	走上
手段	走斷
手財管	還
扎根	展來
打破	打
扣到	到
扣法	扣款
扣繳	拓展
扶持	同時
找出	早出
承做量	很重要
承如	
承擔	成單
把握	把式
投下	
投到	扣到
投影	那
投融資	台灣, 投資, 投資, 投資
投資潮	資產
投資級	呃投資
投資面	這邊
抵抗	比
抵押品	加緊, 一筆
抵給	的比
抵銷	比
拉低	大家, 拉
拉動	把
拉吼	啦齁, 齁啦
拉貨	大作
拉近	拉進來
拉過去	interest
拉長	長期, 發齁, 辦法
拍賣	開賣, 的
拓大	擴大
招呼	
招標	操調
招牌	導開
拜登	大概, 帶動, 帶動
拿捏	
持卡人	思考
持呃	呃
指數型	指型
指日可待	服務
挑戰性	挑戰去
挑挑	剛
挪到	我們到
振興券	
挹注	
挽救	已經
掉下	掉下來
掉下去	下去
排行	還行
掛上	
採納	才
接住	接
接受到	接受
接受度	接受, 接受率
接單	階張
接班	接, 在
接種	塊, 計畫
接種假	
接種率	階動率
接續	接的
接觸點	接觸
控管住	扣除
推升	推申
推推出	可以做
推給	是
推選	房貸
描述	老數
提名	已經
提呃	呃
提振	期待, 提升
提撥	提過, 提過
提防	期綁
換款	放款, 放款
換算回	換項
換言之	包含之後
握有	有, 歸有
揭示	是
搞不好	不讓
搬過去	當過去
搶走	將
撇開	我呃
撥出去	出去
撥放出去	撥放出
撫慰	國内
擔保木	擔保
擔憂	單位
擠壓	只要
擴充	擴通, 從
擴大到	擴大
擴廠	
擺設	擺稅
攀升	一, 分
攜手	方, 第一, 的, 需求, 需求, 吸走, 需求, 其實
攤銷	看銷, 看到
支應	
支持性	支持, 支持
支柱	支出
收ㄖ	收入
收利	收益
收割	個走
收回來	回來, 未來
收支	然後
收款	款
收益性	受益性
收益期	受益的
收緊	收局
收達	收到
收錢	壽險
改寫	
放大	
放心	先
放慢	少
政風	
效力	
救世	就
敬業	第一
整修	
整修完	寫完
數位系	數位
數位話	外匯
數子	數字
數金	順處
斬獲	講過
新人	新的
新保	信保
新冠	新觀, 新光, 銀行, 新管理
新制	行動
新型	
新聞稿	新
新進	
新面孔	新吼
斷言	觀念
斷鍊	專業
方方面	方面
方方面面	放便
方款	放款
於是	可是
於此	
施打	到, 執照, 自然
施打率	
旅游	餘額, 旅遊, 有, 有, 的
旅行社	領色
旅遊業	
旗旗下	旗下
日期	是
日盛	
早日	找日
旺季	
旺年	
昇華	
明年度	的年度, 明年
明明	利率
明朗	敏感
明朗化	快蠻
春節	申請, 簡源, 成帶
春銷	出銷
時代	時態
時期	十期
時機點	實體據點
時限	實現
晚上	往上
普通	股東, 股東, 股東
智金	自己
暑假	暑價
暗示	但是, 辦市
曝顯	曝險
更正	
書本	出口
曼谷	的, 浪戶, 邁股, 内
替代	在
最下方	項
最高峰	最高
會友	會有, 還有
會員數	匯人
會會	各位
有事	有
有加	
有史以來	優
有名	都
有太	
有形	有些
有時	的
有空	有動
有賴	有來
有賴於	有來, 於
有鑑於	有
朝向	廠商, 調向的, 保障, 跑, 好像, 跑, 調向, 調向, 朝
朝著	的朝
期初	清楚
期日	幾
期望	
期滿	平滿
期繳	
期貨	許獲的
期貨債	個也
未未	未來
本質	等項, 本值
本體	整體
杠桿	槓桿, 槓桿
東北亞	東南亞
松江	
查核	
柯志鴻	
柯治宏	
核出來	啦
核定	合併
核貸	大幅, 但, 在
格外	額外
格局	個體
框架	擴大
條例	
梭表	收表
椰子	業者
業管	業本
業績	業界, 業界
極力	提
極致	
概估	代估
概算	帶動
榮光	永光
構思	過
構想	
構面	動面
標地	
標杆	比較
標準值	標的
標的	標地, 標地, 標可以, 標地
標竿	比較, 標剛
模型	公型
樹種	
機場	資產
機票	計畫
檔期	
欄位	出
權益	全益, 權力, 全力
權限	權線, 承現
歐盟	歐本
歡樂	花險的
止穩	
正像	
正向力	證力
正負向	這附向
步伐	步法
歷年以來	第一年來, 歷年來, 歷年來
殊榮	信用
殺戮	效果那
比喻	
比方說	各項, 包括, 比較
比過來	你的
毛手收	毛收, 毛
民生	民間
民衆	營沒有
民行	銀行
氛圍	分為
永續獎	永續, 總需
永豐	公
決策	
沒沒	
油資	有
治療	這
法人戶	法人
法個	法二
法個金	金
法定	法令
法治	保持
法金處	法金, 把金處
法院	法令
波及	了國際
注射	進賣
注意力	注意
泰國	太多
活度	單度
活絡	市場
流出去	留去
流動卡	百分卡
流進來	進來
浪潮	浪好
浮現	股權
海事	還知
海海	的
消費性	消費
消費會	消費
消費金	消費, 消費
消費面	消費方面
涉入	收入, 升
淨利差	淨利, 利差, 淨利
淨增加	競爭家
淨增加額	淨增加
淨手	淨手收
淨收	淨收益
淨淨利收	淨利收
淨零	
淨首手	淨手收
淨首收	定收
深厚	雙厚
清算	簽帳
清華	
清零	
減低	等利, 潛一
減減	
減碳	看, 人, 給他, 給看
減稅	建稅
減項	檢向
測算	項
測試	客戶, 次
渴望	
溫協理	微全
演變	變, 符合, 眼店
漸入佳境	建入加進來
澳幣	報地, 為說, 報定
激勵	機率
激進	基金
炭排	是
為何	會, 為呃
為輔	維持
烏克蘭	可能
無虞	鼓勵, 一
無限	上去, 一些, 微現
照顧	到理這樣, 包括
熔斷	融斷
熟悉度	受性
熱賣	
熱銷	
熱錢	選
燃煤	都
營建業	領建業
營業部	業務, 業務
營用	銀行
營養	一樣
爆發	報告
爆發性	報方性
爭搶	分行
片片	看
物流業	
物資	也
特別股	特別
特惠日	各項
獲保	貨去
獲准	
獲客	顧客, 客客來, 顧客
獲獎數	過獎
獲率	獲利
獲選	
獲頒	全面
玉呃	第呃
玉於	預
玉玉山	利玉山
玉輝	預會
珍惜	升息
現現	現在
理財戶	理財
瑕疵	
瑞士	類, 現在, 是
環保獎	高獎有很
環境面	
環款	放款
生力	生利, 生利
生命	深圳
生態圈	分格, 說
生技股	股
生產率	成長率
產品別	產品點
產能	談
用心	優性
用戶	loan
用餐	資產
申報書	高度
申設	深
申購	分購
申辦	針對
界定為	借爲
界定點	啦
留意	容易
留有	因為有
畢業	第二
略略微	
畫下	花
畫面	我
異地	預計
異常	厲常, 長場
異業	醫院
當出	當初
當期	當成, 當
病毒	並度, 定途, 併度
療法	流法
登入	分募
發債	放在, 十一月做
發出去	辦法出去
發卡行	
發掘到	到
發現到	發到
發發現	發現
發票	嗎
發行量	發量
發覺	發現, 發現
發送	包括
白工	百風
百億	臺幣, 八億
百分	零點九百, 百分之淨收益, 呃
百分之一百一十三點六	百分之一百一三點六
百分之一百二	能
百分之一百二十二點八九	百分之一百三十二點八九
百分之一百二十五	百分之一百二十, 百分之一百二十都
百分之七十點九	是百分之七十點九
百分之七點九	是百分之七點九
百分之七點八	了百分之七點八, 了百分之七點八
百分之三十九	百分之三十九點六
百分之三十二點四	三十二點四
百分之三十六點五	五十六點五
百分之九九	百分之九十九
百分之九十	百分之十
百分之九十五	那個
百分之九十點七	百分之九
百分之二	百分之十二
百分之二十五	百分之二十五呃
百分之二十八	百分之二十趴
百分之二十六點八	了百分之二十六點八
百分之二點四一	百分之二點四億
百分之八十三點三	百分之八十三點有
百分之六	
百分之六十	百分之九十齁
百分之六百六十	百分之六點四
百分之六點二十二點四	百分之六百二十二點四
百分之六點四	了百分之六點四
百分之十	百分之四
百分之十七點三	百分之七點三
百分之十七點九	百分之七點九
百分之十九	百分之十
百分之十二	百分之十二點二, 百分之十二點, 百分之十
百分之十二點七五	百分之十二點七
百分之十五	百分之十五點三
百分之十五點一	百分之十一點一
百分之十四點一	了百分之十四點一
百分之四十六點四	了百分之四十六點四
百分之四十四點九	了百分之四十四點九
百分之四點九	百分之十點九
百分之四點四	百分之十四點四
百分之零點零一	零一
百分之零點零三	百分之五點三, 了百分之零點三
百分之零點零六	百分之零點六
百分五十	百分之五十
盤升	產生
盤整	看重
盤查	看發
直利率	持續利率, 利率
直系	上面
直線	持續, 直接
相似	是
相對的的	相對的
相繼	
相聚	次
相距	相得
盼望	
看懷	看看
看淡	看待, 看到, 看待, 太大, 太大
看見	看加, 辦證, 在, 參加, 看對
真實	跟著
眾多	降多
睡覺	稅後
知名	
知識	就是
短季	短期
短暫性	董事為
短期性	短期, 短決定, 短性
短票	反照
短間期	短期
石化	
研擬	最二
破七	破, 的
破洞	都
硬體	運體, 定期
碳排	思維的, 看法, 放款
碳排量	探卡量, 看排, 上卡量
磯崎	積極
社會面	各方面
祈福	換定
祝福	這麼大家
神秘	現在
神經	曾經
票債	要
票據	票
禁用	進用
福利	股利
福岡	無
私思	
科學家	協價客
科技業	科技
科技類	qand
移上去	上去
移動	一
移動到	到
稅制	稅次
稅局	稅取
稅營	稅在
種下	
種類	準備
穩定性	穩定, 穩定
突出	著出
突然之間	忘見我
立下	利害
立即	嘛
站起來	
端倪	關係
符合性	符合
第一金	第一, 第一
第二億	第二季
第二兆	第二張
第二十	二十月
第二十一	第二十一月, 二十一月
第二十二	
第十七	第十七月, 第十, 第十七億, 十七月, 第七, 第十七月, 第十月, 第十月
第十九	九月, 第十六
第十五	第十, 認第五, 第九, 第五, 第四五
第十八	一十八月, 第三, 第八月, 第八, 第八, 類業, 利十八月
第十六	第十六億, 第六, 第六, 第六, 第十六億, 見第十六
第十四	第十, 一個, 第十, 就, 第二, 第十月, 第十, 第十月, 第十四億
第第三	第三
第第二	第二, 第二, 第二
等一ㄒ	吼等價
答覆	打到
算下來	算下
算到	放到
算回	放款
算法	狀況
管理學	環球
管理層	管理
管理處	管理
管理面	廣裡面
管裡	管理, 管理
管裡層	管理
節制	結制, 截至
節惠	結會, 協位
節能	結合
節能船	結行, 央行
範疇	個看
簽屬	前五
粗粗	透過
粘著度	黏稠度
糟糕	這麼
紀律	揭露
約略	六月
紅兵	第一
納入	如果, 真的, 沒入
納成	那
納進來	拉進來
紓困案	法案, 十五塊, 塊十五, 初那, 客案
紛擾	紛到
紛紛	
累呃	呃
累計	累積, 以及
細緻	去的, 續資
終端	東足, 狀況, 剛剛, 中張, 當
結款	的, 借款
結至	就是
結語	
結購	
絕大部份	絕大部分
統籌	分
統統一	
經典	金點
經歷	金力
經濟率	機制能率
經濟部	
經濟長	經濟
經濟面	精面, 就
經營層	可能
經由	進一步
經繼面	資金
經續	由據
綜合性	分行一定
綠電	例
網絡	網點
網購	廣東, 外
網路債	在網路
緊密	簡易
緊張	舉張
緊急	簡介
縮手	縮
縮減	縮件, 說明, 修點
縮短	它
總存	總放款
總存放比	
總市值	從
總投資	總應該
總收	走收
總收入	收入
總收益	
總整整體	總體
總整體	總體
總數	
總營業	營業費用
總獲利	個獲利
總碳排量	總卡量
總結	總經理, 董事
總結式	總置
總經	總經理
總總	董事方面
總總存款	總放款, 總存款
總餘額	總的, 總也有
績優	
繳出	繳
繳息	
繳掉	在
繳期	
繳限	表現
續約	四月, 這
缺工	千公
美卡	美法
美好	好, 好, 好
聯合國	連, 好
聯準會	會
聯絡	來能夠, 它
聯隊	對
職務	結果
職場	
職能	資合度
肆虐	策略
股票型	股票
肥沃	弱
育輝	預估, 名
肺炎	預分
胡志明	股代, 治
胡志明市	股助, 股市
能否	擔保
自已	自己
自建	之間
自用型	用型
自結	之間, 自己
自行	自己
自認	自任
自貸	自帶
自身	自息, 次在, 製深
自辦	資本
致歉	之前
舊有	有
航空	蠻通常
船舶	韓國
船運	傳面, 反應
茁壯	主軸
莫大	擴大
菁英	經濟
華南	的話, 黃
華爾街日報	還有接
萬一	意義
落幕	
落底	多
著作	呃很多
著手	所
董董事長	董事長
蓄力待發	
蓋藏	
藍圖	
處分掉	這樣子
處所	出售
處理完	逐
融入	榮入
行列	行業
行員	行業
行政院	
行證	成長
衍生性	衍伸性
表現出來	總出來
表面	我們, 保面
衰弱	那
補助	顧客
補回來	未來
補貼	股所以, 股, 股, 股
裡率	
製品	
製建	之間
複合	負額
複數	
襄理	以來, 總經理
要件	躍件
覆蓋	覆蓋率
規避	規定
視窗	是, 上面, 的話, 市場
視訊	匯率
觀光	包括, 包括
觀看	狀況, 幫
解藥	簡要
解釋函	解釋
解開	解決
訂到	並到
訂定	併定
訂購	定購
計算出來	預算
計算器	有是, 替去
計較	到
討論到	跑到
討論完	討論
訓練成	點
記者	呃
設下	有設, 設, 設
設施	方式
許程中	周期
許誠洲	吸承就
評分表	
評為	固理
評鑒	評鑑
詮釋	齁
話題	
認列成	當成
認列為	分股最
認知到	認知道
誠實	隨時
誠誠	跟
調低	兩
調成	發生
講解	
謝冠綸	謝冠仁
證照	增長
警戒	景氣
警訊	
變净	
變相	一定
變變	是
變通	變動
變遷	跟, 建, 電, 變成
變頻	變所以
負值	corporate
負擔	付
負責任	
負面	公務影響, 附面
財富處	財富, 還不錯, 還不錯
財富長	財務長, 財務長
財工	
財源	
財經處	財金處
財訊	海
貨期	活期
貸放	辦, 貸款, 貸款, 帶動
貸放出去	拜出去
貸款案	貸款
費用面	費用
貿易量	貿易戰, 貿易
資安	
資工系	子公司
資本季	本具
資本性	資本
資產品	資產品質
資通訊	資通
質量	持續
賺回	一些, 一些
購債	
購物節	公務就
赤道	知道
走弱	
起立	持齁
起見	其實
超前	過數
超支	
越來	越來呃
足不足夠	多
足跡	主機
趴下來	趴
趴趴	趴
跌到	到
跟進	記得, 感進
跟隨	
跨國	跨, 跨
跨越	
踩到	排到
身分	
身後	
身爲	中為
身體	
軟硬體	網提, 轉募, 短硬期
較多	比較多
較為	較, 較
輔導	付到
輕微	辛苦
輸入到	到
轉佳	轉加
轉加	轉
轉化	轉換
轉合	掌合
轉向	佔比
轉單	轉
轉投資	掌投資, 總是
轉折	轉
轉為	走
辦公	放公
辦理	啊
農曆	努力, 我們
迎來	銀行
近景	進行
返台	團
追問	重要, 最後
追求	追, 久
追蹤	一棟, 這一
逆勢	是, 歷史, 歷史
逆轉	
逐一	逐意, 逐
逐月	逐越
逐次	也會逐字
逐計	逐機
這麽樣	怎麼樣
通成	通膨
通貨	
通貨膨脹	通過, 樂通等到, 通路很
通通路	通路
造福	
連結到	所
連結性	連續
連鑽	連
週年	年, 三十年
週邊	的
進一	借
進程	進展
逼近	接近
逾放比率	預放比率, 預放比率
運用到	業務到
運輸	運數
過往其實	過往
道路	
違反	規範
遞減	季二
遠距	有趣
適合度	資合度
適正	戰成
適量	適得
遵循	幾c
邁入	呃
還款	放款, 還緩
邊境	管住, 精進, 嚴定
部會	顧客
部處	復甦, 顧處
鄰近	民進
酌參	做參考, 看
配對	在對於
配款	分配
配資	最
酬勞	
醫師	ecb
醫術	
采取	個
采用	用
里程碑	成單
重啟	同行
重回	從會
重因	重主要
重心	重新
重疊	重點
重症者	動作的
重複	程戶
量化	讓
量話	量的話
金個	個金
金品	整體, 精體, 精體
金控會	金會
金服	的金處
金產通	
金融史	金融
金融獎	金融
金貸	
金質獎	講
金長	附長
銀行卡	銀行
銷量	下, 在
鋪顯	曝險
錢幣	
鎖定	所
長健	這樣
長度	
長線	呈現, 呃, 線, 長項
長足	上升
長遠性	
開卡	pi卡
開帳	開放
開拓	
開立	
間斷	見, 建端
閱讀	日度
關心到	覺得
關愛	規劃
關懷	包
關閉	
防務	房訴
防疫	反映, 法令, 反應, 房健康, 反, 房
防禦性	房地性, 行性
附帶	大家
附注	速度
附錄	付碼, 速度, 初四
降下	下降
降幅	降低
降溫	加溫
降為	降三點六, 佔
降至	是
限電	證券
陪伴	開放
階層	他
隔離	
隨即	
隱憂	飲, 領域
集合	
雙管齊下	當短期
難以	難, 難, 哪裡
難能可貴	難任可貴
難道	他
雨量	個
雲因	
零八零	零八年
零净林	呃
零受	
零幾	二點零期
零炭排	
零碳	看
零組件	名件
零點一一	連續
零點一二	零點六個
零點一零	零點一五
零點七一	零點七億, 零點七
零點七一一	零點七一
零點七九一	零點七九, 零點七九
零點七九七	零點七九
零點七四	是零點七四
零點三二	零點一, 零點二
零點九二	零點九百
零點二十	零點二一
零點二幾	零點二七
零點五七	零點七
零點八一	零點一八億, 零點八億
零點四一	零點
零點四二	五點四個
零點四五四六	零點四五
零點零	零點零一
零點零七	要, 今年年底
零點零八	呃零點八七
零點零六	零點一六
電力	歷史
電動	變動
電動車	變動呃
電子業	電子
電廠	還
電影	面有
電資	電子, 電置
需不需要	
震蕩	
靜止	電子
靜脈	他
非利收	非利息收入, 非中
靠山	挑戰, 特商, 發生
靠近	跨境
面紗	產品
鞠躬	一起
響應	長, 想
頂級	
頂級卡	平台, 理財, 試到
順心	
預兆	如果
預先	玉山
預山	玉山
預料	非常, 另外, 正式
領導	第一
領導力	連導力
題材	新臺
願景	電子
顛倒	變大
類型	
類推	類
顧及	
顧問式	顧支
顧客數	顧客, 數顧客
顧收	物收
顯得	先的, 選得
風電	風險, 公店, 後面, 方面, 後面, 風險
飛輪	費用
飯店業	放定業
餐廳	參經, 安場
餐飲	單甸, 開業, 看, 阿或者, 乘等
餐飲業	看, 看, 看
餘額會	都會
餘額金	餘額
首創	手辦, 總, 走card, 總上
首度	股東
首重	是
驅動	更
體制	體質
體育	舉
高價格	高的
高出	八億二十
高利	高地
高吼	高齁
高峰期	高金, 高風險
高淨值	
高科技	包括是
高績期	地期高
高資產	那資產
高達	高到
高高	報客群
麽樣	這麼
黃男洲	好像
黏著	年準
黏著度	年度, 年
點一	十點一
點三	百分之十五點三, 四十三點三
點二億	點
點位	電位
點八	四二點八
點八六	八點八六
點六	四點六
點線	線
鼓利	
齁因爲	齁因為
齁齁	齁
齊備	奇備
